WWWWW
WT TW
WB BW
W   W
W   W
WP  W
WWWWW