      WWWW     
      W  WWWWWW
 WWWWWW       W
WW    W WWW   W
WP BBBW WWW WWW
WW          W  
 WWWWWWTWW  W  
      WTWWWWW  
      WTW      
      WWW      
