  WWWW    WWWWW
  WTTWWWWWW   W
  WTTT    B   W
  WTT WWWWWW WW
  WW  W    W W 
   W WW    W W 
   WPW  WWWWBWW
WWWWBWWWW B   W
W             W
W WB BWWWWWWWWW
W W   W        
W WWBWW        
W    W         
WWWWWW         
