 WWWW         WWWW 
 W  WWWWWWWWWWW  W 
WW  B    W    B  WW
W TWWBB  W  BBWWT W
WPTTW    W    WTT W
WWWWW  W   W  WWWWW
    WWWWWWWWWWW    
