WWWWWWW
WT B TW
WW W WW
WT B TW
W B B W
WTW WTW
W B B W
WTW WTW
W B B W
WTW WTW
W B B W
W  P  W
WWWWWWW
