WWWWWWWWWWWW
W         TW
WP BBB    TW
W         TW
WWWWWWWWWWWW
