  WWWW WWWW  
 WW  WWW  WW 
WW   WPW   WW
W  TT   TT  W
W BBBBBBBBB W
WWW       WWW
  WW  W  WW  
   WW   WW   
   W TWT W   
   W TTT W   
   WWWWWWW   
