 WWWWWWW 
WW  T  WW
W TBPBT W
W  BWB  W
W TB BT W
WW  T  WW
 WWWWWW  
