WWWWWWWWWWWWW
WW   TTTT   W
W   WW   W  W
W   WWWWWWBWW
WW  W  W   W 
 W WWWWW WWW 
 W       WPW 
 W WWWW B  W 
 W   B  BW W 
 WWWWWWW   W 
       WWWWW 
