          WWWW     
     WWWW W  W     
   WWW PWWWB W     
  WW      B  W     
 WW  B BBWW WW     
 W  WBWW     W     
 W W B BB W WWW    
 W   B W  W B WWWWW
WWWW    W  BB W   W
WWWW WW B         W
WT    WWW  WWWWWWWW
WTT TTW WWWW       
WTTTWTW            
WTTTTTW            
WWWWWWW            
