WWWWWWWWWWWW  
WTT  W     WWW
WTT  W B  B  W
WTT  WBWWWW  W
WTT    P WW  W
WTT  W W  B WW
WWWWWW WWB B W
  W B  B B B W
  W    W     W
  WWWWWWWWWWWW
