        WWWWWWWW 
        W     PW 
        W BWB WW 
        W B  BW  
        WWB B W  
WWWWWWWWW B W WWW
WTTTT  WW B  B  W
WWTTT    B  B   W
WTTTT  WWWWWWWWWW
WWWWWWWW         
