        WWWWW    
        W   WWWWW
        W WBWW  W
        W     B W
WWWWWWWWW WWW   W
WTTTT  WW B  BWWW
WTTTT    B BB WW 
WTTTT  WWB  B PW 
WWWWWWWWW  B  WW 
        W B B  W 
        WWW WW W 
          W    W 
          WWWWWW 
