          WWWWWWW
          W  TTTW
      WWWWW  TTTW
      W      T TW
      W  WW  TTTW
      WW WW  TTTW
     WWW WWWWWWWW
     W BBB WW    
 WWWWW  B B WWWWW
WW   WB B   W   W
WP B  B    B  B W
WWWWWW BB B WWWWW
     W      W    
     WWWWWWWW    
