 WWW  WWWWWWWWWWWWW
WWPWWWW       W   W
W BB   BB  B B TTTW
W  BBBW    B  WTTTW
W B   W BB BB WTTTW
WWW   W  B    WTTTW
W     W B B B WTTTW
W    WWWWWW WWWTTTW
WW W  W  B B  WTTTW
W  WW W BB B BWWTTW
W TTW W  B      WTW
W TTW W BBB BBB WTW
WWWWW W       W WTW
    W WWWWWWWWW WTW
    W           WTW
    WWWWWWWWWWWWWWW
