       WWWWW 
 WWWWWWW   WW
WW W PWW BB W
W    B      W
W  B  WWW   W
WWW WWWWWBWWW
W B  WWW TTW 
W B B B TTTW 
W    WWWTTTW 
W BB W WTTTW 
W  WWW WWWWW 
WWWW         
