WWWWWW  WWW 
WTT  W WWPWW
WTT  WWW   W
WTT     BB W
WTT  W W B W
WTTWWW W B W
WWWW B WB  W
   W  BW B W
   W B  B  W
   W  WW   W
   W  WW   W
   WWWWWWWWW
