  WWWW          
  W  WWWWWWWWWWW
  W    B   B B W
  W BW B W  B  W
  W  B B  W    W
WWW BW W  WWWW W
WPWB B B  WW   W
W    B WBW   W W
W   B    B B B W
WWWWW  WWWWWWWWW
  W      W      
  W      W      
  WTTTTTTW      
  WTTTTTTW      
  WTTTTTTW      
  WWWWWWWW      
