WWWWWWWWWWWWWWWW 
W              W 
W W WWWWWW     W 
W W  B B B BW  W 
W W   BPB   WW WW
W W  B B BWWWTTTW
W W   B B  WWTTTW
W WWWBBB B WWTTTW
W     W WW WWTTTW
WWWWW   WW WWTTTW
    WWWWW     WWW
        W     W  
        WWWWWWW  
