   WWWWWWWWW       
  WW   WW  WWWWW   
WWW     W  W    WWW
W  B WB W  W  TTT W
W W BWPBWW W WTWT W
W  W WB  W    T T W
W B    B W W WTWT W
W   WW  WWB B T T W
W B W   W  WBWTWT W
WW B  B   B  BTTT W
 WB WWWWWW    WW  W
 W  W     WWWWWWWWW
 WWWW              
