           WWWWWWWW
           W  TTTTW
WWWWWWWWWWWW  TTTTW
W    W  B B   TTTTW
W BBBWB  B W  TTTTW
W  B     B W  TTTTW
W BB WB B BWWWWWWWW
W  B W     W       
WW WWWWWWWWW       
W    W    WW       
W     B   WW       
W  BBWBB  PW       
W    W    WW       
WWWWWWWWWWWW       
