WWWWW
WT TW
W   W
W  BW
WB  W
WP  W
WWWWW